111111111
10P000C01
101000101
11C000E11
101000101
111111111
