111111111
10P000C01
101000101
11C100E11
101000101
111111111
