111111111
100P0C0E1
101000101
110000011
101000101
111111111
