111111111
100P00C01
101000101
11C000E11
101000101
111111111
