11111111111111111111
100000000000000C0001
1P000000000000000E01
11111111111111111111




























































