11111111111111111111111111
10000000000010000000000001
10000000000010000000000001
100000P0CCE010000000000C01
10000000000000000000000001
10000000000010000000000001
10000000000010000000000001
11111111111111111111111111
